# Syntax Colouring Map For ellipse

# Data types (KEYWORD1)
ellipse	KEYWORD1


# Methods and Functions (KEYWORD2)
perimeter	KEYWORD2
area	KEYWORD2
circumference	KEYWORD2
perimeter_ref	KEYWORD2
eccentricity	KEYWORD2

perimeter_Keppler	KEYWORD2
perimeter_Ramanujan1	KEYWORD2
perimeter_Ramanujan2	KEYWORD2

setA	KEYWORD2
setB	KEYWORD2
getA	KEYWORD2
getB	KEYWORD2
getC	KEYWORD2

angle	KEYWORD2


# Constants (LITERAL1)
FLE_LIB_VERSION	LITERAL1

